###############################
#p     ** *  1 * 2 *  * * *   #
# # # #*# # #*#*# # # #*#*#*# #
#  x*     ***  *  1   * 1 * * #
# # # # # #*# # #*#*# # # # #*#
#f    2    x **  *  *   1     #
# # # # # # # # # #*# #*# # # #
#*  *   1  *  *      *     b  #
# # # # #*# # # #*#*# # # # # #
#*    **  *    2  *      1    #
# #*# # # # # # #*# # # # # # #
#    2   f  *   *  *    s     #
###############################